NO ./assets/texture/TOP.xpm
SO ./assets/texture/TOP.xpm
WE ./assets/texture/TOP.xpm
EA ./assets/texture/TOP.xpm

F ./assets/texture/TOP.xpm
C ./assets/texture/TOP.xpm

     111
     1S1
     101
     101
     101
     101
11111101111111
10000000000001
10000000000001
10022022022001
10000000000001
10000030000001
11111111111111
