NO ./assets/texture/TOP.xpm
SO   ./assets/texture/TOP.xpm
WE ./assets/texture/TOP.xpm
EA   ./assets/texture/TOP.xpm

	   	 	 	

F 220,100,0
C      225,30,0



     111
     1S1
     101
     101
     101
     101
11111101111111
10000000000001
10000000000001
10000000000001
10000000000001
10000000000001
11111111111111
