NO ./assets/texture/NO.xpm
SO ./assets/texture/SO.xpm
WE ./assets/texture/WE.xpm
EA ./assets/texture/EA.xpm

F 220,100,0
C      225,30,0

11111111111111111111111111
1E000000000000000000000001
10111111101111111110111101
10000000001000000010001001
11101110111011110111001001
10001000000010000000001001
10000110111010111110111101
10000001000100000000000001
11111101111101111111111111
11111111111101111111111111
     10000000000001
     10000000000001
     10000000000001
     10000000000001
11111111111111111111111111

