NO ./assets/texture/NO.xpm
SO ./assets/texture/SO.xpm
WE ./assets/texture/WE.xpm
EA ./assets/texture/EA.xpm

F ./assets/texture/BOT.xpm
C ./assets/texture/TOP.xpm

11111111111111111111111111
1E000000020000000000900001
19111111191111111110111191
10000000001000000010001001
11121110111011119111001021
10001000000010000000201001
10191101110101111191111221
10002001000100000000200001
11111101111101111111111111
11111111111191111111111111
     10000000000001
     10000200020001
     10000003000001
     10000000000001
11111111111111111111111111

